file_path,class_name,file_npm,extract_npm,file_loc,extract_loc,extract_loc_with_c,lo_comment
org.apache.tools.ant.taskdefs.rmic.RmicAdapterFactory,RmicAdapterFactory,1,1,106,49,106,57
org.apache.tools.ant.taskdefs.optional.perforce.FStatP4OutputHandler,FStatP4OutputHandler,4,3,76,37,60,23
org.apache.tools.ant.taskdefs.optional.junit.OutErrSummaryJUnitResultFormatter,OutErrSummaryJUnitResultFormatter,1,0,7,12,36,24
org.apache.tools.ant.taskdefs.optional.perforce.P4HandlerAdapter,P4HandlerAdapter,8,7,101,51,113,62
org.apache.tools.ant.taskdefs.WaitFor,WaitFor,7,8,185,125,229,104
org.apache.tools.ant.taskdefs.optional.depend.constantpool.ConstantCPInfo,ConstantCPInfo,2,2,16,20,63,43
org.apache.tools.zip.AsiExtraField,AsiExtraField,18,17,345,156,333,177
org.apache.tools.ant.types.resources.comparators.Date,Date,1,11,12,92,162,70
org.apache.tools.ant.util.facade.FacadeTaskHelper,FacadeTaskHelper,9,7,119,66,144,78
org.apache.tools.ant.types.selectors.DepthSelector,DepthSelector,7,6,255,114,185,71
org.apache.tools.ant.taskdefs.optional.dotnet.JSharp,JSharp,6,5,71,59,141,82
org.apache.tools.ant.taskdefs.LogStreamHandler,LogStreamHandler,3,1,38,29,69,40
org.apache.tools.ant.input.InputHandler,InputHandler,1,0,1,8,41,33
org.apache.tools.zip.JarMarker,JarMarker,8,7,54,46,108,62
org.apache.tools.ant.taskdefs.optional.clearcase.CCMkbl,CCMkbl,16,15,252,166,365,199
org.apache.tools.ant.types.resources.Restrict,Restrict,9,7,110,89,148,59
org.apache.tools.ant.DemuxInputStream,DemuxInputStream,3,2,34,28,73,45
org.apache.tools.ant.taskdefs.optional.ejb.IPlanetEjbc,IPlanetEjbc,10,51,835,980,1493,513
org.apache.tools.zip.ZipExtraField,ZipExtraField,6,0,6,20,85,65
org.apache.tools.ant.types.resources.comparators.FileSystem,FileSystem,1,0,41,20,49,29
org.apache.tools.ant.taskdefs.condition.TypeFound,TypeFound,4,3,70,48,90,42
org.apache.tools.ant.taskdefs.optional.perforce.P4OutputHandler,P4OutputHandler,1,0,1,8,34,26
org.apache.tools.ant.taskdefs.email.Message,Message,11,8,181,90,169,79
org.apache.tools.ant.taskdefs.optional.vss.MSVSSCP,MSVSSCP,2,1,51,30,69,39
org.apache.tools.ant.taskdefs.condition.IsSet,IsSet,3,2,29,23,54,31
org.apache.tools.ant.taskdefs.optional.Rpm,Rpm,13,12,483,228,367,139
org.apache.tools.ant.types.selectors.BaseExtendSelector,BaseExtendSelector,3,2,18,32,87,55
org.apache.tools.ant.taskdefs.optional.junit.XMLJUnitResultFormatter,XMLJUnitResultFormatter,11,10,443,192,291,99
org.apache.tools.ant.taskdefs.optional.net.SetProxy,SetProxy,10,9,309,152,281,129
org.apache.tools.ant.util.KeepAliveInputStream,KeepAliveInputStream,2,1,7,15,57,42
org.apache.tools.ant.taskdefs.CallTarget,CallTarget,15,14,204,122,255,133
org.apache.tools.ant.taskdefs.DefBase,DefBase,11,10,108,79,167,88
org.apache.tools.zip.ZipOutputStream,ZipOutputStream,15,13,1286,478,900,422
org.apache.tools.ant.taskdefs.optional.perforce.P4Label,P4Label,5,8,249,118,176,58
org.apache.tools.ant.taskdefs.XSLTLiaison,XSLTLiaison,3,0,4,16,68,52
org.apache.tools.ant.types.resources.BCFileSet,BCFileSet,4,2,57,33,72,39
org.apache.tools.ant.taskdefs.optional.extension.ExtraAttribute,ExtraAttribute,4,3,53,34,83,49
org.apache.tools.ant.taskdefs.optional.vss.MSVSS,MSVSS,9,10,1133,453,777,324
org.apache.tools.ant.util.regexp.Jdk14RegexpRegexp,Jdk14RegexpRegexp,2,1,136,68,105,37
org.apache.tools.ant.taskdefs.condition.AntVersion,AntVersion,6,5,169,79,126,47
org.apache.tools.ant.util.LazyFileOutputStream,LazyFileOutputStream,10,5,136,79,162,83
org.apache.tools.ant.util.LoaderUtils,LoaderUtils,8,7,91,57,139,82
org.apache.tools.ant.loader.AntClassLoader2,AntClassLoader2,1,0,4,9,31,22
org.apache.tools.ant.taskdefs.rmic.ForkingSunRmic,ForkingSunRmic,2,1,72,45,85,40
org.apache.tools.ant.util.StringUtils,StringUtils,7,7,281,135,226,91
org.apache.tools.ant.types.Parameter,Parameter,7,6,43,31,82,51
org.apache.tools.ant.util.regexp.Jdk14RegexpMatcher,Jdk14RegexpMatcher,7,6,130,89,169,80
org.apache.tools.ant.DirectoryScanner,DirectoryScanner,31,30,2303,879,1687,808
org.apache.tools.ant.taskdefs.LogOutputStream,LogOutputStream,3,1,56,45,101,56
org.apache.tools.ant.taskdefs.optional.jsp.JspMangler,JspMangler,2,0,2,12,47,35
org.apache.tools.ant.taskdefs.optional.dotnet.Ildasm,Ildasm,19,21,365,249,474,225
org.apache.tools.ant.taskdefs.Apt,Apt,17,20,137,132,265,133
org.apache.tools.ant.taskdefs.MacroInstance,MacroInstance,8,9,804,333,405,72
org.apache.tools.ant.DemuxOutputStream,DemuxOutputStream,5,4,245,130,248,118
org.apache.tools.ant.types.ZipScanner,ZipScanner,1,0,128,66,104,38
org.apache.tools.ant.taskdefs.ExecTask,ExecTask,30,27,920,400,709,309
org.apache.tools.ant.types.DataType,DataType,7,6,271,153,339,186
org.apache.tools.ant.types.ArchiveFileSet,ArchiveFileSet,29,28,586,275,496,221
org.apache.tools.ant.taskdefs.rmic.XNewRmic,XNewRmic,1,0,19,20,52,32
org.apache.tools.ant.taskdefs.optional.junit.Enumerations,Enumerations,2,6,16,73,177,104
org.apache.tools.ant.taskdefs.Nice,Nice,4,3,76,47,99,52
org.apache.tools.ant.taskdefs.optional.Script,Script,11,10,76,55,132,77
org.apache.tools.ant.taskdefs.optional.junit.JUnitVersionHelper,JUnitVersionHelper,2,1,187,72,119,47
org.apache.tools.ant.AntClassLoader,AntClassLoader,35,31,1842,875,1549,674
org.apache.tools.ant.types.selectors.DifferentSelector,DifferentSelector,3,2,105,54,114,60
org.apache.tools.ant.taskdefs.optional.junit.DOMUtil,DOMUtil,4,6,241,142,225,83
org.apache.tools.ant.types.selectors.modifiedselector.DigestAlgorithm,DigestAlgorithm,7,6,218,118,202,84
org.apache.tools.ant.taskdefs.optional.windows.Attrib,Attrib,12,11,207,107,195,88
org.apache.tools.ant.taskdefs.cvslib.ChangeLogWriter,ChangeLogWriter,2,1,157,78,115,37
org.apache.tools.ant.taskdefs.optional.extension.JarLibDisplayTask,JarLibDisplayTask,4,3,141,60,118,58
org.apache.tools.ant.taskdefs.optional.ssh.SSHExec,SSHExec,7,7,345,183,261,78
org.apache.tools.ant.taskdefs.TaskOutputStream,TaskOutputStream,1,1,67,48,95,47
org.apache.tools.ant.types.resources.comparators.Size,Size,1,5,12,31,73,42
org.apache.tools.ant.types.selectors.MajoritySelector,MajoritySelector,4,3,77,52,105,53
org.apache.tools.ant.taskdefs.condition.IsFailure,IsFailure,4,3,19,21,54,33
org.apache.tools.ant.taskdefs.optional.junit.XalanExecutor,XalanExecutor,0,0,145,77,135,58
org.apache.tools.ant.types.selectors.SizeSelector,SizeSelector,8,8,329,135,262,127
org.apache.tools.ant.taskdefs.optional.Cab,Cab,8,7,566,248,351,103
org.apache.tools.ant.util.TimeoutObserver,TimeoutObserver,1,0,1,7,37,30
org.apache.tools.ant.util.DOMElementWriter,DOMElementWriter,13,10,878,386,577,191
org.apache.tools.ant.types.resources.CompressedResource,CompressedResource,20,18,250,166,304,138
org.apache.tools.ant.taskdefs.optional.depend.ClassFile,ClassFile,4,3,106,65,119,54
org.apache.tools.zip.ZipEntry,ZipEntry,23,20,405,185,368,183
org.apache.tools.ant.types.AntFilterReader,AntFilterReader,10,9,166,88,157,69
org.apache.tools.ant.DynamicAttribute,DynamicAttribute,1,0,1,9,38,29
org.apache.tools.ant.types.selectors.ExtendSelector,ExtendSelector,10,9,249,124,200,76
org.apache.tools.ant.taskdefs.optional.ccm.CCMCheck,CCMCheck,9,8,240,131,207,76
org.apache.tools.ant.taskdefs.JikesOutputParser,JikesOutputParser,5,5,156,103,182,79
org.apache.tools.ant.taskdefs.LoadProperties,LoadProperties,11,10,303,147,233,86
org.apache.tools.ant.types.resources.selectors.Not,Not,4,2,35,28,66,38
org.apache.tools.ant.taskdefs.optional.ReplaceRegExp,ReplaceRegExp,12,11,725,357,547,190
org.apache.tools.ant.taskdefs.BuildNumber,BuildNumber,3,2,258,135,200,65
org.apache.tools.ant.BuildLogger,BuildLogger,4,0,4,15,72,57
org.apache.tools.ant.types.resources.comparators.Reverse,Reverse,3,1,42,31,71,40
org.apache.tools.ant.types.resources.ArchiveResource,ArchiveResource,18,14,361,163,269,106
org.apache.tools.ant.types.resources.First,First,3,2,55,36,70,34
org.apache.tools.ant.taskdefs.email.Mailer,Mailer,18,17,143,97,220,123
org.apache.tools.ant.taskdefs.optional.junit.XMLResultAggregator,XMLResultAggregator,7,6,455,200,328,128
org.apache.tools.ant.util.regexp.RegexpMatcher,RegexpMatcher,6,0,10,30,109,79
org.apache.tools.ant.types.selectors.OrSelector,OrSelector,3,2,52,38,78,40
org.apache.tools.ant.types.spi.Service,Service,7,6,115,73,124,51
org.apache.tools.ant.taskdefs.Pack,Pack,8,7,220,120,205,85
org.apache.tools.ant.taskdefs.optional.ejb.DescriptorHandler,DescriptorHandler,10,9,605,246,389,143
org.apache.tools.ant.taskdefs.optional.jlink.jlink,jlink,9,8,654,333,461,128
org.apache.tools.ant.taskdefs.optional.perforce.SimpleP4OutputHandler,SimpleP4OutputHandler,2,1,103,39,96,57
org.apache.tools.ant.types.Mapper,Mapper,13,14,311,204,306,102
org.apache.tools.ant.Task,Task,19,18,375,214,482,268
org.apache.tools.ant.types.resources.Files,Files,29,24,710,320,504,184
org.apache.tools.ant.types.selectors.modifiedselector.HashvalueAlgorithm,HashvalueAlgorithm,4,3,45,36,79,43
org.apache.tools.ant.util.SourceFileScanner,SourceFileScanner,6,5,148,71,169,98
org.apache.tools.ant.taskdefs.optional.i18n.Translate,Translate,14,13,1034,392,626,234
org.apache.tools.ant.util.optional.WeakishReference12,WeakishReference12,1,0,5,12,45,33
org.apache.tools.ant.types.selectors.FilenameSelector,FilenameSelector,8,7,197,91,166,75
org.apache.tools.ant.taskdefs.optional.junit.FormatterElement,FormatterElement,11,11,286,158,283,125
org.apache.tools.ant.util.regexp.RegexpMatcherFactory,RegexpMatcherFactory,3,2,163,81,136,55
org.apache.tools.ant.taskdefs.Mkdir,Mkdir,3,2,111,55,98,43
org.apache.tools.ant.BuildListener,BuildListener,7,0,7,21,106,85
org.apache.tools.ant.taskdefs.optional.jlink.ClassNameReader,ClassNameReader,2,1,48,89,138,49
org.apache.tools.ant.taskdefs.optional.vss.MSVSSConstants,MSVSSConstants,0,0,48,57,126,69
org.apache.tools.ant.taskdefs.optional.clearcase.CCMklbtype,CCMklbtype,20,19,309,195,440,245
org.apache.tools.ant.taskdefs.optional.pvcs.PvcsProject,PvcsProject,3,2,14,20,49,29
org.apache.tools.ant.filters.StripJavaComments,StripJavaComments,4,2,161,77,145,68
org.apache.tools.ant.taskdefs.Taskdef,Taskdef,1,0,40,14,52,38
org.apache.tools.ant.util.LineTokenizer,LineTokenizer,4,3,125,75,114,39
org.apache.tools.ant.filters.ReplaceTokens,ReplaceTokens,7,9,488,228,374,146
org.apache.tools.ant.PathTokenizer,PathTokenizer,3,2,204,84,165,81
org.apache.tools.ant.filters.BaseParamFilterReader,BaseParamFilterReader,3,1,22,28,73,45
org.apache.tools.ant.types.selectors.MappingSelector,MappingSelector,6,5,143,79,148,69
org.apache.tools.ant.util.ConcatFileInputStream,ConcatFileInputStream,6,5,159,85,136,51
org.apache.tools.ant.taskdefs.condition.And,And,2,1,23,25,58,33
org.apache.tools.ant.taskdefs.optional.javacc.JJTree,JJTree,17,16,678,288,405,117
org.apache.tools.ant.taskdefs.optional.dotnet.DotnetBaseMatchingTask,DotnetBaseMatchingTask,6,5,202,105,194,89
org.apache.tools.ant.filters.ExpandProperties,ExpandProperties,4,2,87,52,113,61
org.apache.tools.ant.types.selectors.modifiedselector.PropertiesfileCache,PropertiesfileCache,12,10,234,137,236,99
org.apache.tools.ant.taskdefs.cvslib.RCSFile,RCSFile,0,0,39,36,69,33
org.apache.tools.ant.types.resources.ZipResource,ZipResource,10,9,213,129,203,74
org.apache.tools.ant.taskdefs.ExecuteStreamHandler,ExecuteStreamHandler,5,0,5,19,68,49
org.apache.tools.ant.taskdefs.optional.dotnet.NetCommand,NetCommand,14,13,517,232,404,172
org.apache.tools.ant.listener.TimestampedLogger,TimestampedLogger,1,0,49,28,67,39
org.apache.tools.mail.ErrorInQuitException,ErrorInQuitException,1,0,6,12,43,31
org.apache.tools.ant.taskdefs.UpToDate,UpToDate,11,10,384,177,272,95
org.apache.tools.ant.types.resources.selectors.Exists,Exists,2,1,8,11,37,26
org.apache.tools.ant.util.ProxySetup,ProxySetup,3,2,76,57,118,61
org.apache.tools.ant.taskdefs.ManifestTask,ManifestTask,7,7,260,134,216,82
org.apache.tools.ant.taskdefs.optional.ccm.Continuus,Continuus,4,3,106,70,144,74
org.apache.tools.ant.util.Retryable,Retryable,1,0,2,10,38,28
org.apache.tools.ant.taskdefs.optional.RenameExtensions,RenameExtensions,6,5,205,82,145,63
org.apache.tools.ant.BuildEvent,BuildEvent,11,8,97,67,201,134
org.apache.tools.ant.util.CompositeMapper,CompositeMapper,2,1,48,27,49,22
org.apache.tools.ant.types.resources.FileResource,FileResource,22,18,397,198,324,126
org.apache.tools.ant.util.ScriptRunnerBase,ScriptRunnerBase,20,19,290,162,307,145
org.apache.tools.ant.taskdefs.cvslib.RedirectingStreamHandler,RedirectingStreamHandler,1,1,40,38,60,22
org.apache.tools.ant.launch.Launcher,Launcher,2,1,566,239,350,111
org.apache.tools.ant.taskdefs.condition.IsTrue,IsTrue,3,2,30,22,55,33
org.apache.tools.ant.taskdefs.Zip,Zip,28,31,2937,1157,1716,559
org.apache.tools.ant.taskdefs.optional.unix.AbstractAccessTask,AbstractAccessTask,5,4,83,47,109,62
org.apache.tools.ant.taskdefs.optional.extension.ExtensionSet,ExtensionSet,7,6,122,59,125,66
org.apache.tools.ant.taskdefs.condition.Or,Or,2,1,23,25,58,33
org.apache.tools.bzip2.BZip2Constants,BZip2Constants,0,0,2064,72,109,37
org.apache.tools.ant.util.GlobPatternMapper,GlobPatternMapper,6,5,185,81,170,89
org.apache.tools.ant.taskdefs.War,War,7,6,195,116,229,113
org.apache.tools.ant.taskdefs.optional.vss.MSVSSADD,MSVSSADD,6,5,95,56,122,66
org.apache.tools.ant.types.Permissions,Permissions,6,13,341,211,335,124
org.apache.tools.ant.taskdefs.condition.HasFreeSpace,HasFreeSpace,6,5,86,56,88,32
org.apache.tools.ant.taskdefs.email.UUMailer,UUMailer,0,0,58,33,55,22
org.apache.tools.ant.types.resources.selectors.ResourceSelector,ResourceSelector,1,0,1,9,35,26
org.apache.tools.ant.util.ResourceUtils,ResourceUtils,10,10,905,375,572,197
org.apache.tools.ant.AntTypeDefinition,AntTypeDefinition,18,17,575,219,369,150
org.apache.tools.ant.taskdefs.AntlibDefinition,AntlibDefinition,5,4,48,34,81,47
org.apache.tools.ant.taskdefs.optional.j2ee.WebLogicHotDeploymentTool,WebLogicHotDeploymentTool,7,6,331,141,246,105
org.apache.tools.ant.taskdefs.optional.vss.MSVSSLABEL,MSVSSLABEL,5,4,94,50,108,58
org.apache.tools.ant.types.selectors.ExtendFileSelector,ExtendFileSelector,0,0,0,9,39,30
org.apache.tools.ant.util.optional.JavaxScriptRunner,JavaxScriptRunner,5,4,236,88,131,43
org.apache.tools.ant.taskdefs.optional.perforce.P4Change,P4Change,5,5,94,83,147,64
org.apache.tools.ant.taskdefs.optional.ssh.Scp,Scp,13,12,741,311,410,99
org.apache.tools.ant.taskdefs.optional.javah.SunJavah,SunJavah,2,1,182,91,123,32
org.apache.tools.ant.types.CommandlineJava,CommandlineJava,33,38,559,393,699,306
org.apache.tools.ant.filters.ClassConstants,ClassConstants,4,2,162,90,164,74
org.apache.tools.ant.taskdefs.optional.clearcase.CCLock,CCLock,15,14,263,171,378,207
org.apache.tools.ant.taskdefs.Cvs,Cvs,1,0,4,8,41,33
org.apache.tools.ant.types.Reference,Reference,9,6,103,59,134,75
org.apache.tools.ant.filters.LineContains,LineContains,7,7,212,117,243,126
org.apache.tools.ant.taskdefs.optional.junit.Constants,Constants,1,0,16,18,38,20
org.apache.tools.ant.taskdefs.Available,Available,17,19,783,324,502,178
org.apache.tools.ant.types.selectors.TypeSelector,TypeSelector,6,6,104,72,135,63
org.apache.tools.ant.taskdefs.Sleep,Sleep,9,8,129,92,191,99
org.apache.tools.ant.types.resources.comparators.ResourceComparator,ResourceComparator,4,3,62,36,81,45
org.apache.tools.ant.types.resources.selectors.Type,Type,4,3,74,52,105,53
org.apache.tools.ant.filters.TabsToSpaces,TabsToSpaces,5,3,126,76,155,79
org.apache.tools.ant.taskdefs.Jikes,Jikes,0,1,182,152,226,74
org.apache.tools.ant.types.ResourceCollection,ResourceCollection,3,0,3,13,50,37
org.apache.tools.ant.util.IdentityStack,IdentityStack,6,4,74,48,102,54
org.apache.tools.ant.UnknownElement,UnknownElement,19,18,900,415,672,257
org.apache.tools.ant.taskdefs.Checksum,Checksum,18,21,1046,454,686,232
org.apache.tools.ant.taskdefs.optional.ejb.WebsphereDeploymentTool,WebsphereDeploymentTool,23,22,1220,604,891,287
org.apache.tools.ant.taskdefs.Basename,Basename,5,4,90,45,109,64
org.apache.tools.ant.taskdefs.optional.javah.Kaffeh,Kaffeh,2,1,111,64,94,30
org.apache.tools.ant.util.ChainedMapper,ChainedMapper,2,1,73,36,60,24
org.apache.tools.ant.taskdefs.optional.ccm.CCMCheckout,CCMCheckout,1,0,7,11,35,24
org.apache.tools.ant.types.resources.BaseResourceCollectionWrapper,BaseResourceCollectionWrapper,8,6,233,133,201,68
org.apache.tools.ant.taskdefs.BUnzip2,BUnzip2,1,0,164,65,109,44
org.apache.tools.ant.util.Base64Converter,Base64Converter,3,2,502,67,108,41
org.apache.tools.ant.taskdefs.optional.ssh.AbstractSshMessage,AbstractSshMessage,4,7,269,175,269,94
org.apache.tools.ant.types.resources.selectors.Majority,Majority,4,2,84,46,84,38
org.apache.tools.ant.taskdefs.FixCRLF,FixCRLF,16,41,457,451,681,230
org.apache.tools.ant.taskdefs.optional.j2ee.HotDeploymentTool,HotDeploymentTool,3,0,8,21,61,40
org.apache.tools.ant.types.resources.Intersect,Intersect,1,0,83,37,63,26
org.apache.tools.ant.taskdefs.Javac,Javac,68,68,1021,572,1023,451
org.apache.tools.ant.types.resources.Touchable,Touchable,1,0,1,5,32,27
org.apache.tools.ant.taskdefs.optional.extension.resolvers.LocationResolver,LocationResolver,4,3,36,28,64,36
org.apache.tools.ant.taskdefs.optional.sos.SOSGet,SOSGet,5,4,106,50,116,66
org.apache.tools.ant.types.ArchiveScanner,ArchiveScanner,12,11,344,171,335,164
org.apache.tools.ant.taskdefs.optional.depend.constantpool.Utf8CPInfo,Utf8CPInfo,4,3,27,26,67,41
org.apache.tools.ant.types.resources.JavaResource,JavaResource,11,9,279,132,211,79
org.apache.tools.ant.taskdefs.optional.ejb.IPlanetDeploymentTool,IPlanetDeploymentTool,7,6,450,192,384,192
org.apache.tools.ant.types.selectors.SelectorContainer,SelectorContainer,24,0,24,58,186,128
org.apache.tools.ant.taskdefs.email.MimeMailer,MimeMailer,2,9,379,237,286,49
org.apache.tools.ant.taskdefs.optional.ssh.Directory,Directory,15,13,161,107,193,86
org.apache.tools.ant.types.FilterSetCollection,FilterSetCollection,5,3,69,51,100,49
org.apache.tools.ant.taskdefs.optional.depend.DirectoryIterator,DirectoryIterator,2,1,120,88,164,76
org.apache.tools.ant.taskdefs.condition.IsSigned,IsSigned,5,4,193,87,134,47
org.apache.tools.ant.taskdefs.cvslib.CvsVersion,CvsVersion,7,6,210,96,153,57
org.apache.tools.ant.taskdefs.optional.jlink.ConstantPool,ConstantPool,0,13,115,222,357,135
org.apache.tools.ant.taskdefs.optional.clearcase.CCCheckout,CCCheckout,20,19,392,236,516,280
org.apache.tools.ant.taskdefs.XSLTProcess,XSLTProcess,31,53,1254,713,1223,510
org.apache.tools.ant.TypeAdapter,TypeAdapter,5,0,5,15,66,51
org.apache.tools.ant.taskdefs.SQLExec,SQLExec,20,25,881,493,789,296
org.apache.tools.ant.taskdefs.optional.clearcase.CCCheckin,CCCheckin,14,13,241,153,343,190
org.apache.tools.ant.util.FileUtils,FileUtils,56,55,1752,715,1531,816
org.apache.tools.ant.PropertyHelper,PropertyHelper,18,17,689,330,629,299
org.apache.tools.ant.taskdefs.optional.dotnet.ImportTypelib,ImportTypelib,8,7,224,121,217,96
org.apache.tools.ant.taskdefs.optional.extension.resolvers.URLResolver,URLResolver,6,5,133,82,132,50
org.apache.tools.ant.taskdefs.optional.native2ascii.KaffeNative2Ascii,KaffeNative2Ascii,1,0,77,51,88,37
org.apache.tools.ant.types.Substitution,Substitution,4,3,33,30,77,47
org.apache.tools.ant.taskdefs.cvslib.CvsUser,CvsUser,6,5,51,44,93,49
org.apache.tools.zip.ExtraFieldUtils,ExtraFieldUtils,6,5,388,110,174,64
org.apache.tools.ant.filters.TailFilter,TailFilter,6,4,328,136,242,106
org.apache.tools.ant.taskdefs.optional.junit.Xalan2Executor,Xalan2Executor,1,0,115,65,96,31
org.apache.tools.ant.taskdefs.Length,Length,14,14,348,241,329,88
org.apache.tools.ant.types.selectors.SelectSelector,SelectSelector,12,11,199,119,211,92
org.apache.tools.ant.listener.AnsiColorLogger,AnsiColorLogger,1,0,251,127,243,116
org.apache.tools.ant.types.Quantifier,Quantifier,5,3,195,84,144,60
org.apache.tools.ant.taskdefs.optional.clearcase.ClearCase,ClearCase,9,8,189,108,241,133
org.apache.tools.ant.taskdefs.optional.clearcase.CCUnlock,CCUnlock,9,8,184,117,260,143
org.apache.tools.ant.taskdefs.ResourceCount,ResourceCount,8,7,133,72,124,52
org.apache.tools.ant.taskdefs.Concat,Concat,20,29,879,634,898,264
org.apache.tools.ant.util.ScriptRunnerCreator,ScriptRunnerCreator,2,1,156,89,138,49
org.apache.tools.ant.types.resources.comparators.Content,Content,3,2,34,29,70,41
org.apache.tools.ant.taskdefs.optional.ssh.SSHUserInfo,SSHUserInfo,20,18,125,106,216,110
org.apache.tools.ant.util.JavaEnvUtils,JavaEnvUtils,11,11,463,261,443,182
org.apache.tools.ant.util.XmlConstants,XmlConstants,1,0,15,25,61,36
org.apache.tools.ant.taskdefs.Unpack,Unpack,8,7,202,109,187,78
org.apache.tools.ant.taskdefs.optional.extension.ExtensionResolver,ExtensionResolver,1,0,1,10,42,32
org.apache.tools.tar.TarUtils,TarUtils,8,7,271,115,199,84
org.apache.tools.zip.UnixStat,UnixStat,0,0,7,15,75,60
org.apache.tools.ant.types.FileList,FileList,10,11,192,119,220,101
org.apache.tools.ant.taskdefs.optional.TraXLiaison,TraXLiaison,15,14,712,376,569,193
org.apache.tools.ant.ExitException,ExitException,3,1,27,20,59,39
org.apache.tools.ant.taskdefs.optional.net.MimeMail,MimeMail,2,1,22,13,43,30
org.apache.tools.ant.launch.Locator,Locator,9,10,968,295,456,161
org.apache.tools.ant.taskdefs.optional.depend.constantpool.IntegerCPInfo,IntegerCPInfo,3,2,25,21,56,35
org.apache.tools.ant.taskdefs.optional.perforce.P4Labelsync,P4Labelsync,9,8,156,71,150,79
org.apache.tools.ant.taskdefs.optional.dotnet.VisualBasicCompile,VisualBasicCompile,19,18,269,176,366,190
org.apache.tools.ant.taskdefs.optional.extension.JarLibAvailableTask,JarLibAvailableTask,6,5,191,90,156,66
org.apache.tools.ant.DynamicElement,DynamicElement,1,0,1,7,36,29
org.apache.tools.ant.taskdefs.email.Header,Header,5,4,24,24,61,37
org.apache.tools.ant.taskdefs.Tstamp,Tstamp,4,13,135,212,340,128
org.apache.tools.ant.taskdefs.optional.sound.SoundTask,SoundTask,5,10,82,108,192,84
org.apache.tools.ant.taskdefs.optional.javacc.JJDoc,JJDoc,7,6,377,161,215,54
org.apache.tools.ant.types.selectors.modifiedselector.Cache,Cache,7,0,7,23,72,49
org.apache.tools.ant.types.TarFileSet,TarFileSet,15,14,274,154,268,114
org.apache.tools.ant.taskdefs.optional.ejb.JonasDeploymentTool,JonasDeploymentTool,16,15,1230,531,823,292
org.apache.tools.tar.TarConstants,TarConstants,0,0,25,57,158,101
org.apache.tools.ant.taskdefs.compilers.Sj,Sj,2,1,44,27,61,34
org.apache.tools.ant.taskdefs.optional.perforce.P4Delete,P4Delete,3,2,55,22,65,43
org.apache.tools.ant.taskdefs.optional.EchoProperties,EchoProperties,9,13,615,344,539,195
org.apache.tools.ant.taskdefs.condition.Http,Http,4,3,105,53,89,36
org.apache.tools.ant.taskdefs.Rename,Rename,5,4,104,55,95,40
org.apache.tools.ant.taskdefs.optional.depend.ClassFileIterator,ClassFileIterator,1,0,1,7,33,26
org.apache.tools.ant.taskdefs.optional.depend.constantpool.ConstantPoolEntry,ConstantPoolEntry,7,6,124,122,221,99
org.apache.tools.ant.taskdefs.optional.perforce.P4OutputStream,P4OutputStream,3,2,68,44,85,41
org.apache.tools.ant.taskdefs.condition.Matches,Matches,8,7,122,71,128,57
org.apache.tools.ant.taskdefs.Exec,Exec,7,8,359,190,280,90
org.apache.tools.ant.taskdefs.optional.jsp.compilers.JspCompilerAdapter,JspCompilerAdapter,4,0,4,18,64,46
org.apache.tools.ant.util.TaskLogger,TaskLogger,6,5,43,32,79,47
org.apache.tools.ant.taskdefs.optional.junit.BriefJUnitResultFormatter,BriefJUnitResultFormatter,11,10,292,142,249,107
org.apache.tools.ant.taskdefs.condition.FilesMatch,FilesMatch,5,4,70,49,100,51
org.apache.tools.ant.taskdefs.optional.clearcase.CCRmtype,CCRmtype,16,15,285,164,373,209
org.apache.tools.ant.util.PackageNameMapper,PackageNameMapper,1,0,20,12,46,34
org.apache.tools.ant.types.selectors.SelectorUtils,SelectorUtils,15,15,1004,449,683,234
org.apache.tools.ant.taskdefs.optional.Javah,Javah,29,30,466,260,465,205
org.apache.tools.ant.taskdefs.LoadFile,LoadFile,2,1,12,12,40,28
org.apache.tools.ant.taskdefs.condition.HasMethod,HasMethod,9,8,231,122,183,61
org.apache.tools.ant.taskdefs.WhichResource,WhichResource,7,6,214,110,182,72
org.apache.tools.ant.types.resources.Difference,Difference,1,0,82,41,67,26
org.apache.tools.ant.taskdefs.optional.sound.AntSoundPlayer,AntSoundPlayer,11,10,230,142,241,99
org.apache.tools.ant.taskdefs.optional.j2ee.GenericHotDeploymentTool,GenericHotDeploymentTool,9,6,94,59,140,81
org.apache.tools.ant.util.facade.ImplementationSpecificArgument,ImplementationSpecificArgument,3,2,25,24,61,37
org.apache.tools.ant.taskdefs.Move,Move,1,0,791,283,386,103
org.apache.tools.ant.taskdefs.condition.Equals,Equals,6,5,74,41,88,47
org.apache.tools.ant.types.Comparison,Comparison,4,2,185,49,95,46
org.apache.tools.ant.taskdefs.optional.junit.JUnitTaskMirrorImpl,JUnitTaskMirrorImpl,4,5,56,72,106,34
org.apache.tools.ant.IntrospectionHelper,IntrospectionHelper,24,35,2098,919,1477,558
org.apache.tools.ant.taskdefs.XSLTLoggerAware,XSLTLoggerAware,1,0,1,6,31,25
org.apache.tools.ant.taskdefs.cvslib.ChangeLogTask,ChangeLogTask,10,9,498,261,419,158
org.apache.tools.ant.taskdefs.optional.depend.constantpool.FieldRefCPInfo,FieldRefCPInfo,7,6,108,68,130,62
org.apache.tools.ant.taskdefs.cvslib.ChangeLogParser,ChangeLogParser,3,3,381,174,262,88
org.apache.tools.ant.dispatch.Dispatchable,Dispatchable,1,0,1,5,31,26
org.apache.tools.ant.taskdefs.cvslib.CvsTagDiff,CvsTagDiff,8,7,623,282,457,175
org.apache.tools.bzip2.CBZip2OutputStream,CBZip2OutputStream,8,6,4541,1758,2106,348
org.apache.tools.ant.taskdefs.condition.Os,Os,12,10,400,148,312,164
org.apache.tools.ant.util.ScriptRunnerHelper,ScriptRunnerHelper,13,12,165,105,191,86
org.apache.tools.ant.taskdefs.Exit,Exit,8,8,282,123,217,94
org.apache.tools.ant.util.MergingMapper,MergingMapper,4,3,24,18,58,40
org.apache.tools.ant.taskdefs.MacroDef,MacroDef,16,49,573,509,821,312
org.apache.tools.ant.taskdefs.TempFile,TempFile,8,7,90,62,144,82
org.apache.tools.ant.taskdefs.MakeUrl,MakeUrl,8,7,372,168,297,129
org.apache.tools.ant.taskdefs.optional.sos.SOSCmd,SOSCmd,0,0,26,31,80,49
org.apache.tools.ant.taskdefs.condition.IsReachable,IsReachable,5,4,278,112,207,95
org.apache.tools.ant.taskdefs.DefaultExcludes,DefaultExcludes,6,5,131,63,115,52
org.apache.tools.ant.filters.StripLineBreaks,StripLineBreaks,5,3,107,71,153,82
org.apache.tools.ant.taskdefs.Transform,Transform,1,0,4,5,30,25
org.apache.tools.ant.DefaultLogger,DefaultLogger,12,11,356,177,332,155
org.apache.tools.ant.util.ClasspathUtils,ClasspathUtils,10,24,261,219,499,280
org.apache.tools.ant.types.resources.Sort,Sort,2,7,75,109,147,38
org.apache.tools.ant.taskdefs.Copydir,Copydir,7,6,274,109,163,54
org.apache.tools.ant.types.PatternSet,PatternSet,17,22,625,341,512,171
org.apache.tools.ant.types.Environment,Environment,4,11,51,81,176,95
org.apache.tools.ant.helper.ProjectHelperImpl,ProjectHelperImpl,2,21,315,546,1036,490
org.apache.tools.ant.taskdefs.Expand,Expand,11,10,631,281,394,113
org.apache.tools.ant.types.selectors.BaseSelectorContainer,BaseSelectorContainer,28,27,204,154,313,159
org.apache.tools.ant.taskdefs.optional.javah.JavahAdapter,JavahAdapter,1,0,1,9,38,29
org.apache.tools.ant.types.selectors.PresentSelector,PresentSelector,7,7,198,101,181,80
org.apache.tools.ant.input.MultipleChoiceInputRequest,MultipleChoiceInputRequest,3,2,44,24,57,33
org.apache.tools.ant.taskdefs.EchoXML,EchoXML,4,3,85,53,93,40
org.apache.tools.mail.MailMessage,MailMessage,13,12,615,328,525,197
org.apache.tools.ant.taskdefs.optional.depend.constantpool.DoubleCPInfo,DoubleCPInfo,3,2,25,20,58,38
org.apache.tools.ant.taskdefs.condition.Socket,Socket,4,3,85,47,86,39
org.apache.tools.ant.ExitStatusException,ExitStatusException,4,1,29,25,67,42
org.apache.tools.ant.Target,Target,24,22,528,228,458,230
org.apache.tools.ant.types.resources.comparators.Name,Name,1,5,11,35,77,42
org.apache.tools.ant.taskdefs.condition.Contains,Contains,5,4,64,33,76,43
org.apache.tools.ant.taskdefs.optional.junit.JUnitTaskMirror,JUnitTaskMirror,3,0,3,60,188,128
org.apache.tools.ant.ProjectComponent,ProjectComponent,10,9,75,59,170,111
org.apache.tools.ant.filters.StripLineComments,StripLineComments,5,5,172,110,223,113
org.apache.tools.ant.taskdefs.optional.dotnet.CSharp,CSharp,15,14,249,171,399,228
org.apache.tools.ant.types.ResourceFactory,ResourceFactory,1,0,1,6,38,32
org.apache.tools.ant.DynamicConfiguratorNS,DynamicConfiguratorNS,0,0,0,5,27,22
org.apache.tools.ant.types.TimeComparison,TimeComparison,7,5,136,58,122,64
org.apache.tools.ant.taskdefs.optional.vss.MSVSSCREATE,MSVSSCREATE,4,3,71,40,91,51
org.apache.tools.tar.TarBuffer,TarBuffer,17,11,620,302,461,159
org.apache.tools.ant.types.selectors.NotSelector,NotSelector,4,2,44,33,73,40
org.apache.tools.ant.util.depend.bcel.AncestorAnalyzer,AncestorAnalyzer,1,0,202,92,138,46
org.apache.tools.ant.taskdefs.DependSet,DependSet,8,10,304,157,246,89
org.apache.tools.ant.taskdefs.optional.dotnet.Ilasm,Ilasm,20,20,376,272,540,268
org.apache.tools.ant.types.selectors.DependSelector,DependSelector,3,2,76,40,78,38
org.apache.tools.ant.types.resources.TarResource,TarResource,9,6,265,129,194,65
org.apache.tools.ant.taskdefs.optional.perforce.P4Submit,P4Submit,5,5,56,74,154,80
org.apache.tools.ant.types.Parameterizable,Parameterizable,1,0,1,5,31,26
org.apache.tools.ant.taskdefs.Copy,Copy,27,27,1828,705,1015,310
org.apache.tools.ant.util.WeakishReference,WeakishReference,2,2,22,33,91,58
org.apache.tools.ant.taskdefs.CVSPass,CVSPass,5,4,1254,118,171,53
org.apache.tools.ant.types.LogLevel,LogLevel,3,2,101,48,87,39
org.apache.tools.ant.taskdefs.optional.dotnet.WsdlToDotnet,WsdlToDotnet,15,29,322,322,595,273
org.apache.tools.ant.types.PropertySet,PropertySet,20,28,610,325,506,181
org.apache.tools.ant.taskdefs.optional.j2ee.ServerDeploy,ServerDeploy,9,8,75,61,152,91
org.apache.tools.ant.util.CollectionUtils,CollectionUtils,7,15,105,123,204,81
org.apache.tools.ant.Project,Project,103,103,2384,1093,2390,1297
org.apache.tools.ant.taskdefs.optional.jsp.JspNameMangler,JspNameMangler,3,2,373,95,159,64
org.apache.tools.ant.taskdefs.Replace,Replace,16,25,788,537,831,294
org.apache.tools.ant.taskdefs.optional.clearcase.CCMkdir,CCMkdir,8,7,178,105,237,132
org.apache.tools.zip.UnrecognizedExtraField,UnrecognizedExtraField,10,9,76,55,137,82
org.apache.tools.ant.taskdefs.optional.SchemaValidate,SchemaValidate,9,20,345,324,526,202
org.apache.tools.ant.types.Path,Path,28,31,1021,437,717,280
org.apache.tools.ant.taskdefs.optional.clearcase.CCMkelem,CCMkelem,18,17,307,185,424,239
org.apache.tools.ant.types.RegularExpression,RegularExpression,5,4,110,62,141,79
org.apache.tools.ant.types.resources.FailFast,FailFast,3,3,156,87,133,46
org.apache.tools.ant.taskdefs.CopyPath,CopyPath,9,8,260,124,206,82
org.apache.tools.ant.taskdefs.compilers.Jvc,Jvc,2,1,149,76,115,39
org.apache.tools.ant.types.resolver.ApacheCatalogResolver,ApacheCatalogResolver,5,4,123,81,177,96
org.apache.tools.ant.taskdefs.optional.extension.Specification,Specification,13,11,703,364,604,240
org.apache.tools.ant.taskdefs.optional.script.ScriptDefBase,ScriptDefBase,7,6,152,72,131,59
org.apache.tools.ant.taskdefs.optional.clearcase.CCUpdate,CCUpdate,14,13,234,142,331,189
org.apache.tools.ant.taskdefs.optional.depend.Depend,Depend,12,11,1542,639,880,241
org.apache.tools.ant.taskdefs.optional.perforce.P4Base,P4Base,13,12,312,151,304,153
org.apache.tools.tar.TarOutputStream,TarOutputStream,14,11,469,203,355,152
org.apache.tools.ant.types.resources.Resources,Resources,6,16,240,180,235,55
org.apache.tools.ant.taskdefs.optional.ssh.ScpFromMessage,ScpFromMessage,5,1,404,184,245,61
org.apache.tools.ant.taskdefs.optional.junit.JUnitResultFormatter,JUnitResultFormatter,5,0,5,19,63,44
org.apache.tools.ant.taskdefs.Ear,Ear,4,3,147,81,150,69
org.apache.tools.ant.util.Tokenizer,Tokenizer,2,0,2,10,44,34
org.apache.tools.ant.taskdefs.Rmic,Rmic,44,44,837,425,743,318
org.apache.tools.ant.input.DefaultInputHandler,DefaultInputHandler,2,1,152,79,124,45
org.apache.tools.ant.util.RegexpPatternMapper,RegexpPatternMapper,6,5,186,82,150,68
org.apache.tools.ant.taskdefs.optional.ccm.CCMCheckinDefault,CCMCheckinDefault,1,0,11,14,38,24
org.apache.tools.ant.taskdefs.condition.Condition,Condition,1,0,1,9,35,26
org.apache.tools.ant.taskdefs.optional.unix.Chgrp,Chgrp,3,2,52,33,84,51
org.apache.tools.ant.taskdefs.XSLTLiaison2,XSLTLiaison2,1,0,1,6,33,27
org.apache.tools.ant.taskdefs.XSLTLiaison3,XSLTLiaison3,1,0,1,7,35,28
org.apache.tools.ant.taskdefs.rmic.RmicAdapter,RmicAdapter,4,0,4,19,67,48
org.apache.tools.ant.util.java15.ProxyDiagnostics,ProxyDiagnostics,3,1,121,72,111,39
org.apache.tools.ant.taskdefs.condition.Xor,Xor,2,1,25,19,48,29
org.apache.tools.ant.util.FlatFileNameMapper,FlatFileNameMapper,4,3,20,15,54,39
org.apache.tools.ant.filters.util.JavaClassHelper,JavaClassHelper,2,1,89,38,69,31
org.apache.tools.ant.taskdefs.optional.ejb.InnerClassFilenameFilter,InnerClassFilenameFilter,1,1,47,24,54,30
org.apache.tools.ant.types.resources.selectors.Compare,Compare,6,5,167,98,147,49
org.apache.tools.ant.taskdefs.optional.depend.constantpool.FloatCPInfo,FloatCPInfo,3,2,25,21,56,35
org.apache.tools.ant.util.FileNameMapper,FileNameMapper,3,0,3,11,60,49
org.apache.tools.ant.taskdefs.optional.perforce.P4Counter,P4Counter,5,5,134,72,151,79
org.apache.tools.ant.types.resources.ImmutableResourceException,ImmutableResourceException,2,0,9,16,45,29
org.apache.tools.ant.taskdefs.optional.ejb.BorlandGenerateClient,BorlandGenerateClient,10,9,468,209,312,103
org.apache.tools.ant.util.optional.NoExitSecurityManager,NoExitSecurityManager,3,2,12,14,50,36
org.apache.tools.ant.filters.util.ChainReaderHelper,ChainReaderHelper,8,7,353,163,237,74
org.apache.tools.ant.taskdefs.ManifestException,ManifestException,1,0,5,8,34,26
org.apache.tools.ant.taskdefs.ExecuteWatchdog,ExecuteWatchdog,8,6,141,86,177,91
org.apache.tools.ant.util.TeeOutputStream,TeeOutputStream,6,5,70,44,95,51
org.apache.tools.ant.taskdefs.optional.perforce.P4Handler,P4Handler,2,0,2,12,43,31
org.apache.tools.ant.taskdefs.optional.clearcase.CCMkattr,CCMkattr,16,15,333,201,425,224
org.apache.tools.ant.util.regexp.RegexpFactory,RegexpFactory,3,2,119,67,115,48
org.apache.tools.ant.taskdefs.optional.extension.LibFileSet,LibFileSet,4,3,34,36,117,81
org.apache.tools.ant.taskdefs.optional.extension.Compatibility,Compatibility,1,1,12,13,57,44
org.apache.tools.ant.types.resources.StringResource,StringResource,14,13,185,120,216,96
org.apache.tools.ant.filters.TokenFilter,TokenFilter,19,38,319,424,721,297
org.apache.tools.ant.util.OutputStreamFunneler,OutputStreamFunneler,4,7,146,119,176,57
org.apache.tools.ant.taskdefs.SubAnt,SubAnt,27,25,778,360,607,247
org.apache.tools.ant.types.optional.depend.DependScanner,DependScanner,15,14,202,116,213,97
org.apache.tools.ant.launch.AntMain,AntMain,1,0,1,9,42,33
org.apache.tools.ant.taskdefs.Ant,Ant,19,21,1139,503,783,280
org.apache.tools.ant.util.ReflectWrapper,ReflectWrapper,6,4,58,43,99,56
org.apache.tools.ant.types.selectors.SelectorScanner,SelectorScanner,3,0,3,11,49,38
org.apache.tools.ant.util.DateUtils,DateUtils,8,8,314,129,271,142
org.apache.tools.ant.types.FilterChain,FilterChain,25,24,189,144,299,155
org.apache.tools.ant.launch.LaunchException,LaunchException,1,0,5,9,37,28
org.apache.tools.ant.taskdefs.optional.native2ascii.Native2AsciiAdapter,Native2AsciiAdapter,1,0,1,10,42,32
org.apache.tools.ant.input.GreedyInputHandler,GreedyInputHandler,2,1,80,49,81,32
org.apache.tools.ant.types.optional.ScriptMapper,ScriptMapper,6,5,55,42,93,51
org.apache.tools.ant.types.resolver.ApacheCatalog,ApacheCatalog,3,2,96,56,121,65
org.apache.tools.ant.taskdefs.StreamPumper,StreamPumper,8,6,182,100,178,78
org.apache.tools.ant.taskdefs.optional.perforce.P4Edit,P4Edit,3,2,55,25,73,48
org.apache.tools.ant.taskdefs.optional.vss.MSVSSCHECKIN,MSVSSCHECKIN,6,5,92,51,114,63
org.apache.tools.ant.DynamicElementNS,DynamicElementNS,1,0,1,6,37,31
org.apache.tools.ant.taskdefs.JDBCTask,JDBCTask,20,21,526,301,472,171
org.apache.tools.ant.taskdefs.email.EmailTask,EmailTask,32,32,941,350,580,230
org.apache.tools.ant.taskdefs.Execute,Execute,25,34,1095,746,1230,484
org.apache.tools.ant.taskdefs.optional.XMLValidateTask,XMLValidateTask,16,28,796,452,745,293
org.apache.tools.ant.types.optional.depend.ClassfileSet,ClassfileSet,6,7,163,79,163,84
org.apache.tools.ant.util.KeepAliveOutputStream,KeepAliveOutputStream,2,1,7,15,56,41
org.apache.tools.ant.taskdefs.optional.jlink.JlinkTask,JlinkTask,8,7,217,106,182,76
org.apache.tools.ant.XmlLogger,XmlLogger,12,12,682,320,484,164
org.apache.tools.ant.taskdefs.optional.junit.XMLConstants,XMLConstants,0,0,22,47,138,91
org.apache.tools.ant.filters.StringInputStream,StringInputStream,2,0,17,17,49,32
org.apache.tools.ant.taskdefs.rmic.DefaultRmicAdapter,DefaultRmicAdapter,5,7,390,281,427,146
org.apache.tools.ant.taskdefs.Dirname,Dirname,4,3,48,34,83,49
org.apache.tools.ant.taskdefs.optional.perforce.P4Fstat,P4Fstat,6,5,323,127,198,71
org.apache.tools.ant.taskdefs.optional.vss.MSVSSCHECKOUT,MSVSSCHECKOUT,10,9,122,69,165,96
org.apache.tools.ant.taskdefs.optional.extension.LibraryDisplayer,LibraryDisplayer,0,0,211,94,149,55
org.apache.tools.ant.types.TarScanner,TarScanner,1,0,108,53,91,38
org.apache.tools.ant.filters.ConcatFilter,ConcatFilter,8,6,217,110,215,105
org.apache.tools.ant.taskdefs.ImportTask,ImportTask,4,3,178,89,153,64
org.apache.tools.ant.taskdefs.optional.perforce.P4Resolve,P4Resolve,12,11,298,106,187,81
org.apache.tools.ant.taskdefs.SendEmail,SendEmail,2,1,10,10,45,35
org.apache.tools.ant.taskdefs.Delete,Delete,40,39,1100,489,736,247
org.apache.tools.ant.util.StringTokenizer,StringTokenizer,7,6,194,96,152,56
org.apache.tools.ant.taskdefs.Input,Input,8,14,190,158,256,98
org.apache.tools.ant.taskdefs.optional.sos.SOS,SOS,13,12,534,257,476,219
org.apache.tools.ant.taskdefs.optional.dotnet.DotnetDefine,DotnetDefine,7,6,72,50,102,52
org.apache.tools.ant.taskdefs.optional.ccm.CCMCheckin,CCMCheckin,1,0,18,15,39,24
org.apache.tools.ant.SubBuildListener,SubBuildListener,2,0,2,9,58,49
org.apache.tools.ant.taskdefs.XmlProperty,XmlProperty,15,14,1020,440,791,351
org.apache.tools.ant.types.resources.GZipResource,GZipResource,2,0,24,29,75,46
org.apache.tools.ant.Main,Main,5,3,2117,721,1043,322
org.apache.tools.ant.filters.LineContainsRegExp,LineContainsRegExp,7,5,221,111,222,111
org.apache.tools.ant.taskdefs.optional.junit.JUnitTask,JUnitTask,36,39,2328,1093,1792,699
org.apache.tools.ant.types.FileSet,FileSet,5,4,67,45,94,49
org.apache.tools.ant.taskdefs.condition.ResourcesMatch,ResourcesMatch,4,3,100,54,93,39
org.apache.tools.ant.taskdefs.ConditionTask,ConditionTask,5,4,148,58,115,57
org.apache.tools.ant.taskdefs.Java,Java,43,38,1152,539,939,400
org.apache.tools.ant.util.depend.DependencyAnalyzer,DependencyAnalyzer,10,0,10,30,129,99
org.apache.tools.ant.taskdefs.optional.sos.SOSCheckout,SOSCheckout,3,2,68,34,85,51
org.apache.tools.ant.types.optional.ScriptCondition,ScriptCondition,4,3,26,24,69,45
org.apache.tools.ant.util.FileTokenizer,FileTokenizer,3,2,11,16,47,31
org.apache.tools.ant.taskdefs.Copyfile,Copyfile,6,5,135,67,115,48
org.apache.tools.ant.taskdefs.optional.ssh.ScpFromMessageBySftp,ScpFromMessageBySftp,3,1,298,127,169,42
org.apache.tools.ant.TaskAdapter,TaskAdapter,6,5,261,84,161,77
org.apache.tools.ant.taskdefs.AntStructure,AntStructure,4,7,182,348,469,121
org.apache.tools.ant.taskdefs.cvslib.CVSEntry,CVSEntry,9,8,88,50,112,62
org.apache.tools.ant.NoBannerLogger,NoBannerLogger,4,3,57,36,88,52
org.apache.tools.ant.taskdefs.Antlib,Antlib,4,3,212,102,165,63
org.apache.tools.ant.types.resources.selectors.InstanceOf,InstanceOf,9,8,123,75,130,55
org.apache.tools.ant.taskdefs.optional.jsp.WLJspc,WLJspc,7,6,586,195,328,133
org.apache.tools.ant.MagicNames,MagicNames,0,0,26,52,169,117
org.apache.tools.ant.types.RedirectorElement,RedirectorElement,24,23,860,417,607,190
org.apache.tools.ant.taskdefs.compilers.Kjc,Kjc,2,1,145,81,119,38
org.apache.tools.ant.types.resources.selectors.None,None,3,1,33,25,58,33
org.apache.tools.ant.taskdefs.Classloader,Classloader,10,9,260,135,241,106
org.apache.tools.ant.taskdefs.optional.ejb.WeblogicTOPLinkDeploymentTool,WeblogicTOPLinkDeploymentTool,4,3,98,61,112,51
org.apache.tools.ant.DynamicConfigurator,DynamicConfigurator,0,0,0,7,29,22
org.apache.tools.ant.taskdefs.optional.j2ee.JonasHotDeploymentTool,JonasHotDeploymentTool,7,6,345,142,251,109
org.apache.tools.ant.taskdefs.optional.clearcase.CCUnCheckout,CCUnCheckout,4,3,109,61,141,80
org.apache.tools.ant.taskdefs.optional.vss.MSVSSHISTORY,MSVSSHISTORY,11,11,173,94,199,105
org.apache.tools.ant.DynamicAttributeNS,DynamicAttributeNS,1,0,1,9,41,32
org.apache.tools.ant.taskdefs.Tar,Tar,10,21,1224,608,952,344
org.apache.tools.ant.taskdefs.rmic.WLRmic,WLRmic,4,3,130,65,109,44
org.apache.tools.ant.taskdefs.SignJar,SignJar,15,14,455,270,500,230
org.apache.tools.ant.taskdefs.Definer,Definer,16,20,800,429,640,211
org.apache.tools.ant.taskdefs.optional.extension.JarLibResolveTask,JarLibResolveTask,9,8,369,171,285,114
org.apache.tools.ant.taskdefs.compilers.AptExternalCompilerAdapter,AptExternalCompilerAdapter,2,1,50,35,71,36
org.apache.tools.ant.taskdefs.optional.jsp.compilers.DefaultJspCompilerAdapter,DefaultJspCompilerAdapter,5,4,129,84,152,68
org.apache.tools.ant.types.ResourceLocation,ResourceLocation,7,6,43,38,106,68
org.apache.tools.ant.types.selectors.modifiedselector.ModifiedSelector,ModifiedSelector,36,38,1031,530,958,428
org.apache.tools.ant.taskdefs.optional.depend.AntAnalyzer,AntAnalyzer,1,0,241,108,151,43
org.apache.tools.ant.taskdefs.condition.ConditionBase,ConditionBase,21,21,198,132,306,174
org.apache.tools.ant.taskdefs.optional.perforce.P4Integrate,P4Integrate,26,25,399,155,318,163
org.apache.tools.ant.util.ReflectUtil,ReflectUtil,5,5,125,78,139,61
org.apache.tools.ant.taskdefs.optional.ccm.CCMCreateTask,CCMCreateTask,19,18,377,199,334,135
org.apache.tools.ant.taskdefs.Get,Get,10,15,493,265,440,175
org.apache.tools.ant.util.RetryHandler,RetryHandler,2,1,74,39,74,35
org.apache.tools.ant.types.mappers.FilterMapper,FilterMapper,4,3,74,49,85,36
org.apache.tools.zip.ZipFile,ZipFile,10,8,598,335,568,233
org.apache.tools.ant.taskdefs.compilers.CompilerAdapterFactory,CompilerAdapterFactory,1,1,221,111,176,65
org.apache.tools.ant.util.LazyHashtable,LazyHashtable,8,7,60,55,120,65
org.apache.tools.ant.types.selectors.DateSelector,DateSelector,13,12,377,161,262,101
org.apache.tools.ant.taskdefs.optional.script.ScriptDef,ScriptDef,14,17,492,237,386,149
org.apache.tools.ant.taskdefs.condition.IsFileSelected,IsFileSelected,5,4,72,44,80,36
org.apache.tools.ant.taskdefs.ExecuteOn,ExecuteOn,20,18,1270,497,742,245
org.apache.tools.ant.taskdefs.PathConvert,PathConvert,15,18,507,275,487,212
org.apache.tools.tar.TarEntry,TarEntry,34,30,776,358,638,280
org.apache.tools.ant.taskdefs.optional.jsp.Jasper41Mangler,Jasper41Mangler,3,2,127,52,92,40
org.apache.tools.ant.taskdefs.optional.depend.constantpool.MethodRefCPInfo,MethodRefCPInfo,7,6,108,68,133,65
org.apache.tools.ant.taskdefs.Echo,Echo,8,7,141,75,149,74
org.apache.tools.ant.util.DOMUtils,DOMUtils,7,6,66,46,168,122
org.apache.tools.ant.helper.DefaultExecutor,DefaultExecutor,3,2,45,35,60,25
org.apache.tools.ant.taskdefs.optional.extension.Compatability,Compatability,1,1,12,13,57,44
org.apache.tools.ant.util.Watchdog,Watchdog,6,5,112,62,126,64
org.apache.tools.ant.taskdefs.optional.vss.MSVSSGET,MSVSSGET,11,10,130,73,172,99
org.apache.tools.ant.taskdefs.DiagnosticsTask,DiagnosticsTask,2,1,14,17,43,26
org.apache.tools.ant.util.DeweyDecimal,DeweyDecimal,10,8,298,121,212,91
org.apache.tools.ant.types.Commandline,Commandline,27,32,644,350,620,270
org.apache.tools.ant.UnsupportedElementException,UnsupportedElementException,2,1,13,15,56,41
org.apache.tools.ant.taskdefs.optional.ccm.CCMReconfigure,CCMReconfigure,8,7,120,91,159,68
org.apache.tools.ant.Executor,Executor,2,0,2,11,42,31
org.apache.tools.ant.taskdefs.Recorder,Recorder,17,17,206,150,313,163
org.apache.tools.ant.types.selectors.AbstractSelectorContainer,AbstractSelectorContainer,27,26,191,141,288,147
org.apache.tools.ant.types.resources.Tokens,Tokens,3,2,146,86,128,42
org.apache.tools.ant.taskdefs.compilers.Javac13,Javac13,2,1,66,36,69,33
org.apache.tools.ant.taskdefs.compilers.Javac12,Javac12,2,1,163,57,89,32
org.apache.tools.ant.taskdefs.optional.perforce.P4Revert,P4Revert,4,3,81,37,85,48
org.apache.tools.ant.filters.HeadFilter,HeadFilter,6,4,251,115,214,99
org.apache.tools.ant.taskdefs.optional.junit.JUnitTestRunner,JUnitTestRunner,24,34,1561,745,1036,291
org.apache.tools.ant.dispatch.DispatchTask,DispatchTask,4,4,17,19,59,40
org.apache.tools.ant.types.resources.PropertyResource,PropertyResource,9,8,134,79,148,69
org.apache.tools.ant.taskdefs.Jar,Jar,13,14,1413,647,985,338
org.apache.tools.ant.taskdefs.optional.jsp.JspC,JspC,36,37,707,395,692,297
org.apache.tools.zip.ZipLong,ZipLong,10,7,154,59,134,75
org.apache.tools.ant.util.depend.AbstractAnalyzer,AbstractAnalyzer,10,10,254,139,284,145
org.apache.tools.ant.util.ReaderInputStream,ReaderInputStream,9,7,246,128,205,77
org.apache.tools.ant.types.selectors.ContainsSelector,ContainsSelector,9,8,266,129,207,78
org.apache.tools.ant.taskdefs.GenerateKey,GenerateKey,14,21,378,275,419,144
org.apache.tools.ant.types.resources.BaseResourceCollectionContainer,BaseResourceCollectionContainer,11,9,310,166,249,83
org.apache.tools.ant.taskdefs.Typedef,Typedef,1,0,4,7,46,39
org.apache.tools.ant.helper.SingleCheckExecutor,SingleCheckExecutor,3,2,17,22,47,25
org.apache.tools.ant.types.Resource,Resource,27,25,471,222,423,201
org.apache.tools.ant.taskdefs.optional.perforce.P4Add,P4Add,5,4,195,73,142,69
org.apache.tools.ant.taskdefs.optional.PropertyFile,PropertyFile,5,17,214,414,666,252
org.apache.tools.ant.types.Description,Description,3,2,144,77,122,45
org.apache.tools.ant.types.FlexInteger,FlexInteger,3,2,19,18,54,36
org.apache.tools.ant.taskdefs.Filter,Filter,5,4,94,52,100,48
org.apache.tools.ant.taskdefs.AbstractCvsTask,AbstractCvsTask,33,32,898,473,802,329
org.apache.tools.ant.taskdefs.optional.extension.ExtensionUtil,ExtensionUtil,0,0,264,144,215,71
org.apache.tools.ant.taskdefs.optional.unix.Chown,Chown,3,2,52,33,84,51
org.apache.tools.ant.BuildException,BuildException,15,8,153,88,209,121
org.apache.tools.ant.taskdefs.Sync,Sync,12,14,549,273,472,199
org.apache.tools.ant.taskdefs.optional.depend.ClassFileUtils,ClassFileUtils,3,2,19,13,51,38
org.apache.tools.ant.types.EnumeratedAttribute,EnumeratedAttribute,8,8,130,72,153,81
org.apache.tools.ant.taskdefs.optional.jsp.compilers.JasperC,JasperC,3,2,280,126,181,55
org.apache.tools.ant.taskdefs.optional.ejb.IPlanetEjbcTask,IPlanetEjbcTask,10,9,386,168,319,151
org.apache.tools.ant.taskdefs.optional.javacc.JavaCC,JavaCC,27,26,822,367,556,189
org.apache.tools.ant.util.ConcatResourceInputStream,ConcatResourceInputStream,7,6,156,93,147,54
org.apache.tools.ant.types.selectors.modifiedselector.EqualComparator,EqualComparator,3,2,24,23,58,35
org.apache.tools.ant.taskdefs.condition.IsFalse,IsFalse,3,2,34,22,55,33
org.apache.tools.ant.taskdefs.RecorderEntry,RecorderEntry,17,17,460,214,356,142
org.apache.tools.ant.dispatch.DispatchUtils,DispatchUtils,2,0,265,98,123,25
org.apache.tools.ant.util.regexp.Regexp,Regexp,1,0,3,13,50,37
org.apache.tools.ant.taskdefs.optional.sos.SOSLabel,SOSLabel,4,3,81,41,91,50
org.apache.tools.ant.taskdefs.Manifest,Manifest,16,41,616,677,1075,398
org.apache.tools.ant.taskdefs.optional.ejb.EjbJar,EjbJar,26,27,503,308,628,320
org.apache.tools.ant.taskdefs.optional.jdepend.JDependTask,JDependTask,28,26,977,445,679,234
org.apache.tools.bzip2.CBZip2InputStream,CBZip2InputStream,4,3,2106,854,976,122
org.apache.tools.ant.taskdefs.compilers.JavacExternal,JavacExternal,2,1,116,56,92,36
org.apache.tools.ant.taskdefs.optional.ANTLR,ANTLR,18,16,671,291,436,145
org.apache.tools.ant.taskdefs.optional.ejb.BorlandDeploymentTool,BorlandDeploymentTool,14,13,877,366,557,191
org.apache.tools.ant.listener.MailLogger,MailLogger,2,1,487,186,283,97
org.apache.tools.ant.taskdefs.optional.clearcase.CCMklabel,CCMklabel,16,15,302,187,402,215
org.apache.tools.ant.util.UUEncoder,UUEncoder,2,1,202,86,143,57
org.apache.tools.ant.taskdefs.ExecuteJava,ExecuteJava,13,12,552,231,330,99
org.apache.tools.ant.taskdefs.condition.ParserSupports,ParserSupports,7,6,165,95,151,56
org.apache.tools.ant.taskdefs.optional.sos.SOSCheckin,SOSCheckin,4,3,87,42,101,59
org.apache.tools.ant.types.selectors.modifiedselector.Algorithm,Algorithm,2,0,2,13,48,35
org.apache.tools.ant.util.depend.bcel.DependencyVisitor,DependencyVisitor,9,8,203,97,188,91
org.apache.tools.ant.taskdefs.KeySubst,KeySubst,8,7,281,129,199,70
org.apache.tools.ant.types.FilterSet,FilterSet,19,24,811,384,615,231
org.apache.tools.ant.taskdefs.optional.depend.constantpool.NameAndTypeCPInfo,NameAndTypeCPInfo,6,5,84,50,112,62
org.apache.tools.ant.types.selectors.modifiedselector.ChecksumAlgorithm,ChecksumAlgorithm,6,5,135,83,149,66
org.apache.tools.ant.taskdefs.XSLTLogger,XSLTLogger,1,0,1,6,31,25
org.apache.tools.ant.input.PropertyFileInputHandler,PropertyFileInputHandler,2,1,101,52,91,39
org.apache.tools.ant.types.DTDLocation,DTDLocation,1,0,4,4,33,29
org.apache.tools.ant.taskdefs.optional.perforce.P4Sync,P4Sync,4,3,108,46,107,61
org.apache.tools.ant.taskdefs.Deltree,Deltree,3,2,147,69,111,42
org.apache.tools.ant.taskdefs.rmic.KaffeRmic,KaffeRmic,3,2,137,63,104,41
org.apache.tools.ant.input.InputRequest,InputRequest,7,6,42,41,93,52
org.apache.tools.ant.UnsupportedAttributeException,UnsupportedAttributeException,2,1,13,16,48,32
org.apache.tools.ant.taskdefs.Touch,Touch,13,16,515,244,369,125
org.apache.tools.ant.types.selectors.SignedSelector,SignedSelector,3,2,35,22,58,36
org.apache.tools.ant.filters.PrefixLines,PrefixLines,5,3,150,82,163,81
org.apache.tools.ant.taskdefs.optional.splash.SplashTask,SplashTask,9,8,380,177,247,70
org.apache.tools.ant.taskdefs.Patch,Patch,11,10,247,112,187,75
org.apache.tools.ant.types.optional.ScriptSelector,ScriptSelector,16,15,140,102,223,121
org.apache.tools.ant.taskdefs.email.EmailAddress,EmailAddress,7,5,284,125,197,72
org.apache.tools.ant.types.XMLCatalog,XMLCatalog,13,16,874,692,1107,415
org.apache.tools.ant.taskdefs.optional.native2ascii.Native2AsciiAdapterFactory,Native2AsciiAdapterFactory,3,2,79,38,88,50
org.apache.tools.bzip2.CRC,CRC,0,0,1107,114,141,27
org.apache.tools.ant.taskdefs.compilers.AptCompilerAdapter,AptCompilerAdapter,2,1,171,92,189,97
org.apache.tools.ant.taskdefs.GZip,GZip,1,0,71,28,67,39
org.apache.tools.ant.taskdefs.cvslib.CvsTagEntry,CvsTagEntry,7,4,105,55,109,54
org.apache.tools.ant.util.ContainerMapper,ContainerMapper,7,6,89,55,118,63
org.apache.tools.ant.util.XMLFragment,XMLFragment,4,6,90,83,156,73
org.apache.tools.ant.taskdefs.optional.junit.SummaryJUnitResultFormatter,SummaryJUnitResultFormatter,12,11,223,104,177,73
org.apache.tools.ant.taskdefs.Redirector,Redirector,30,29,1212,528,826,298
org.apache.tools.zip.ZipShort,ZipShort,10,7,121,58,133,75
org.apache.tools.ant.types.resources.FileResourceIterator,FileResourceIterator,8,5,109,53,107,54
org.apache.tools.ant.TaskContainer,TaskContainer,1,0,1,7,42,35
org.apache.tools.ant.types.selectors.AndSelector,AndSelector,3,2,52,38,77,39
org.apache.tools.ant.util.regexp.JakartaOroRegexp,JakartaOroRegexp,2,1,105,61,99,38
org.apache.tools.ant.taskdefs.compilers.CompilerAdapter,CompilerAdapter,2,0,2,13,52,39
org.apache.tools.ant.taskdefs.optional.dotnet.DotnetCompile,DotnetCompile,38,38,888,537,994,457
org.apache.tools.ant.taskdefs.optional.junit.PlainJUnitResultFormatter,PlainJUnitResultFormatter,11,10,386,160,248,88
org.apache.tools.ant.taskdefs.Sequential,Sequential,3,2,32,24,65,41
org.apache.tools.ant.types.AbstractFileSet,AbstractFileSet,57,52,1035,485,815,330
org.apache.tools.ant.taskdefs.optional.depend.constantpool.InterfaceMethodRefCPInfo,InterfaceMethodRefCPInfo,7,6,108,69,137,68
org.apache.tools.ant.FileScanner,FileScanner,14,0,14,33,158,125
org.apache.tools.ant.taskdefs.optional.ejb.EJBDeploymentTool,EJBDeploymentTool,4,0,4,20,60,40
org.apache.tools.ant.taskdefs.optional.extension.JarLibManifestTask,JarLibManifestTask,7,6,355,174,314,140
org.apache.tools.ant.taskdefs.optional.extension.Extension,Extension,16,15,850,409,689,280
org.apache.tools.ant.util.IdentityMapper,IdentityMapper,4,3,16,15,52,37
org.apache.tools.ant.util.JAXPUtils,JAXPUtils,9,6,155,128,258,130
org.apache.tools.ant.util.UnPackageNameMapper,UnPackageNameMapper,1,0,20,12,48,36
org.apache.tools.ant.taskdefs.MatchingTask,MatchingTask,40,35,327,226,445,219
org.apache.tools.ant.taskdefs.optional.ejb.GenericDeploymentTool,GenericDeploymentTool,10,9,1367,625,952,327
org.apache.tools.ant.taskdefs.rmic.SunRmic,SunRmic,2,1,167,63,103,40
org.apache.tools.ant.types.resources.Union,Union,5,3,122,69,122,53
org.apache.tools.ant.Diagnostics,Diagnostics,5,6,1038,474,650,176
org.apache.tools.ant.util.LineOrientedOutputStream,LineOrientedOutputStream,5,4,143,77,140,63
org.apache.tools.ant.taskdefs.optional.splash.SplashScreen,SplashScreen,11,9,213,117,134,17
org.apache.tools.ant.types.optional.ScriptFilter,ScriptFilter,12,11,98,74,168,94
org.apache.tools.ant.taskdefs.optional.jsp.compilers.JspCompilerAdapterFactory,JspCompilerAdapterFactory,2,2,97,52,121,69
org.apache.tools.ant.taskdefs.LoadResource,LoadResource,8,7,336,148,232,84
org.apache.tools.ant.taskdefs.optional.extension.ExtensionAdapter,ExtensionAdapter,10,9,214,121,227,106
org.apache.tools.ant.taskdefs.optional.depend.constantpool.ClassCPInfo,ClassCPInfo,5,4,51,36,93,57
org.apache.tools.ant.util.regexp.JakartaOroMatcher,JakartaOroMatcher,7,6,135,86,168,82
org.apache.tools.ant.types.spi.Provider,Provider,4,3,37,28,63,35
org.apache.tools.ant.taskdefs.optional.perforce.P4Have,P4Have,2,1,25,12,46,34
org.apache.tools.ant.taskdefs.optional.Native2Ascii,Native2Ascii,14,16,362,188,300,112
org.apache.tools.ant.taskdefs.optional.j2ee.AbstractHotDeploymentTool,AbstractHotDeploymentTool,13,12,109,82,193,111
org.apache.tools.ant.Location,Location,9,6,134,85,177,92
org.apache.tools.ant.types.ZipFileSet,ZipFileSet,4,3,143,79,147,68
org.apache.tools.ant.taskdefs.GUnzip,GUnzip,1,0,129,52,96,44
org.apache.tools.ant.util.LeadPipeInputStream,LeadPipeInputStream,9,5,177,89,158,69
org.apache.tools.ant.helper.AntXMLContext,AntXMLContext,28,27,300,192,367,175
org.apache.tools.ant.util.regexp.JakartaRegexpMatcher,JakartaRegexpMatcher,7,6,129,84,161,77
org.apache.tools.ant.util.regexp.JakartaRegexpRegexp,JakartaRegexpRegexp,2,1,95,52,89,37
org.apache.tools.ant.taskdefs.optional.pvcs.Pvcs,Pvcs,32,31,1006,435,679,244
org.apache.tools.tar.TarInputStream,TarInputStream,15,12,538,244,393,149
org.apache.tools.ant.types.selectors.NoneSelector,NoneSelector,3,2,52,38,78,40
org.apache.tools.ant.types.selectors.FileSelector,FileSelector,1,0,1,14,48,34
org.apache.tools.ant.taskdefs.Chmod,Chmod,16,13,305,135,259,124
org.apache.tools.ant.types.selectors.ContainsRegexpSelector,ContainsRegexpSelector,7,6,209,113,172,59
org.apache.tools.ant.types.resources.BZip2Resource,BZip2Resource,2,0,70,39,85,46
org.apache.tools.ant.taskdefs.optional.ssh.ScpToMessageBySftp,ScpToMessageBySftp,7,3,285,173,243,70
org.apache.tools.ant.types.Assertions,Assertions,10,15,289,187,366,179
org.apache.tools.ant.taskdefs.condition.IsReference,IsReference,4,3,68,49,89,40
org.apache.tools.ant.helper.ProjectHelper2,ProjectHelper2,4,26,461,673,1121,448
org.apache.tools.ant.taskdefs.optional.junit.AggregateTransformer,AggregateTransformer,8,7,451,219,346,127
org.apache.tools.ant.util.depend.bcel.FullAnalyzer,FullAnalyzer,1,0,185,85,131,46
org.apache.tools.ant.taskdefs.optional.ssh.LogListener,LogListener,1,0,1,6,30,24
org.apache.tools.ant.taskdefs.ProcessDestroyer,ProcessDestroyer,5,6,335,137,221,84
org.apache.tools.ant.filters.EscapeUnicode,EscapeUnicode,4,2,107,60,128,68
org.apache.tools.ant.taskdefs.optional.native2ascii.DefaultNative2Ascii,DefaultNative2Ascii,2,1,53,39,105,66
org.apache.tools.ant.util.regexp.RegexpUtil,RegexpUtil,3,2,20,13,49,36
org.apache.tools.ant.taskdefs.PumpStreamHandler,PumpStreamHandler,9,5,183,126,232,106
org.apache.tools.ant.taskdefs.Parallel,Parallel,9,12,519,285,459,174
org.apache.tools.ant.util.PropertyOutputStream,PropertyOutputStream,3,1,49,31,69,38
org.apache.tools.ant.taskdefs.email.PlainMailer,PlainMailer,1,1,250,103,137,34
org.apache.tools.ant.taskdefs.optional.extension.resolvers.AntResolver,AntResolver,6,5,104,69,116,47
org.apache.tools.ant.taskdefs.compilers.DefaultCompilerAdapter,DefaultCompilerAdapter,3,2,1167,457,648,191
org.apache.tools.ant.taskdefs.optional.ssh.SSHBase,SSHBase,16,15,184,112,223,111
org.apache.tools.ant.taskdefs.optional.dotnet.DotnetResource,DotnetResource,14,13,297,144,248,104
org.apache.tools.ant.taskdefs.optional.depend.constantpool.LongCPInfo,LongCPInfo,3,2,25,21,56,35
org.apache.tools.ant.taskdefs.BZip2,BZip2,1,0,82,34,73,39
org.apache.tools.ant.taskdefs.Property,Property,25,24,807,388,641,253
org.apache.tools.ant.taskdefs.optional.depend.constantpool.StringCPInfo,StringCPInfo,4,3,46,30,74,44
org.apache.tools.ant.taskdefs.cvslib.RedirectingOutputStream,RedirectingOutputStream,1,0,14,16,46,30
org.apache.tools.ant.filters.BaseFilterReader,BaseFilterReader,5,3,146,94,198,104
org.apache.tools.ant.types.DirSet,DirSet,6,5,103,59,114,55
org.apache.tools.ant.taskdefs.optional.native2ascii.SunNative2Ascii,SunNative2Ascii,1,0,82,41,70,29
org.apache.tools.ant.taskdefs.PreSetDef,PreSetDef,4,18,112,142,275,133
org.apache.tools.ant.taskdefs.optional.javah.JavahAdapterFactory,JavahAdapterFactory,3,2,79,37,87,50
org.apache.tools.ant.types.optional.AbstractScriptComponent,AbstractScriptComponent,10,9,91,66,144,78
org.apache.tools.ant.taskdefs.optional.ejb.WeblogicDeploymentTool,WeblogicDeploymentTool,23,22,1196,630,927,297
org.apache.tools.ant.types.resources.comparators.DelegatedResourceComparator,DelegatedResourceComparator,4,3,169,80,124,44
org.apache.tools.ant.filters.ChainableReader,ChainableReader,1,0,1,7,37,30
org.apache.tools.ant.types.resources.URLResource,URLResource,18,14,409,228,367,139
org.apache.tools.ant.taskdefs.Untar,Untar,3,4,182,121,223,102
org.apache.tools.ant.listener.CommonsLoggingListener,CommonsLoggingListener,12,11,459,237,332,95
org.apache.tools.ant.ComponentHelper,ComponentHelper,26,29,1711,669,1027,358
org.apache.tools.ant.RuntimeConfigurable,RuntimeConfigurable,22,21,515,249,475,226
org.apache.tools.mail.SmtpResponseReader,SmtpResponseReader,3,2,108,49,100,51
org.apache.tools.ant.taskdefs.VerifyJar,VerifyJar,3,9,179,147,208,61
org.apache.tools.ant.taskdefs.optional.ssh.ScpToMessage,ScpToMessage,9,3,402,204,287,83
org.apache.tools.ant.taskdefs.optional.unix.Symlink,Symlink,16,15,856,342,592,250
org.apache.tools.ant.ProjectHelper,ProjectHelper,17,17,386,255,545,290
org.apache.tools.ant.listener.Log4jListener,Log4jListener,8,7,305,123,179,56
org.apache.tools.ant.filters.FixCrLfFilter,FixCrLfFilter,16,44,331,689,1000,311
org.apache.tools.ant.taskdefs.AbstractJarSignerTask,AbstractJarSignerTask,13,12,348,191,379,188
org.apache.tools.ant.taskdefs.optional.ejb.JbossDeploymentTool,JbossDeploymentTool,3,2,160,63,110,47
org.apache.tools.ant.taskdefs.ManifestClassPath,ManifestClassPath,6,5,292,119,187,68
org.apache.tools.ant.taskdefs.optional.perforce.P4Reopen,P4Reopen,3,2,53,24,60,36
org.apache.tools.ant.taskdefs.Javadoc,Javadoc,81,119,2704,1501,2373,872
org.apache.tools.ant.types.selectors.BaseSelector,BaseSelector,6,5,46,49,110,61
org.apache.tools.ant.types.resources.selectors.ResourceSelectorContainer,ResourceSelectorContainer,6,4,141,79,129,50
org.apache.tools.ant.taskdefs.compilers.Gcj,Gcj,3,2,216,99,147,48
org.apache.tools.ant.taskdefs.optional.depend.JarFileIterator,JarFileIterator,2,1,83,54,89,35
